gecko

TraitSymbiosis     Симбиоз             = ages
TraitCommunication Сотрудничество      = relationship-bounds 
TraitCooperation   Взаимодействие      = duality   / body-swapping / telepathy
TraitCarnivorous   Хищник              = croc-jaws / bestial-fangs
TraitParasite      Паразит             = earth-worm / alien-egg
TraitFatTissue     Жировой запас       = fat
TraitSwimming      Водоплавающее       = dolphin
TraitRunning       Быстрое             = sprint
TraitMimicry       Мимикрия            = dodging 
TraitScavenger     Падальщик           = vulture
TraitPiracy        Пиратство           = snatch / robber
TraitTailLoss      Отбрасывание хвоста = half-body-crawling / fox-tail
TraitGrazing       Топотун             = stomp / boot-stomp
TraitMassive       Большой             = body-height / muscular-torso / biceps
TraitHibernation   Спячка              = pillow / bed / coma
TraitPoisonous     Ядовитое            = poison-bottle / biohazard 
TraitBurrowing     Норное              = tumulus
TraitCamouflage    Камуфляж            = invisible
TraitSharpVision   Острое зрение       = beast-eye
                     = 
TraitShell         Раковина            = ammonite
TraitIntellect     Интеллект           = brain
TraitAnglerfish    Удильщик            = piranha
TraitTrematode     Трематода           = earth-worm / two-shadows / duality
TraitMetamorphose  Метаморфоза         = transform/ bandaged   
TraitInkCloud      Чернильное облако   = fluffy-trefoil / fluffy-cloud   
TraitViviparous    Живорождение        = minions   
TraitAmbush        Засада              = grass   
TraitFlight        Полет               = feather / bat-wing   
TraitSpecA         Специализация       = clubs / spades                    
TraitSpecB         Специализация       = clubs / spades
